00000000000000000000
00000000000000000000
00000000000000000000
00000000000000000000
00000000000000000000
00000000001100000000
00000000001100000000
00000000011100000000
00001111111111000100
00001122221100333000
00001122221133330000
00000002000000333000
00000002000000000000
00000002220000000000
22222222222222222222
